0 10 10 200
1 30 10 200.07
2 50 10 200.14
3 70 10 200.21
4 90 10 200.28
5 110 10 200.35
6 130 10 200.42
7 150 10 200.49
8 170 10 200.56
9 190 10 200.63
10 210 10 200.7
11 230 10 200.77
12 250 10 200.84
13 270 10 200.91
14 10 30 200.98
15 30 30 201.05
16 50 30 201.12
17 70 30 201.19
18 90 30 201.26
19 110 30 201.33
20 130 30 201.4
21 150 30 201.47
22 170 30 201.54
23 190 30 201.61
24 210 30 201.68
25 230 30 201.75
26 250 30 201.82
27 270 30 201.89
28 10 50 201.96
29 30 50 202.03
30 50 50 202.1
31 70 50 202.17
32 90 50 202.24
33 110 50 202.31
34 130 50 202.38
35 150 50 202.45
36 170 50 202.52
37 190 50 202.59
38 210 50 202.66
39 230 50 202.73
40 250 50 202.8
41 270 50 202.87
42 10 70 202.94
43 30 70 203.01
44 50 70 203.08
45 70 70 203.15
46 90 70 203.22
47 110 70 203.29
48 130 70 203.36
49 150 70 203.43
50 170 70 203.5
51 190 70 203.57
52 210 70 203.64
53 230 70 203.71
54 250 70 203.78
55 270 70 203.85
56 10 90 203.92
57 30 90 203.99
58 50 90 204.06
59 70 90 204.13
60 90 90 204.2
61 110 90 204.27
62 130 90 204.34
63 150 90 204.41
64 170 90 204.48
65 190 90 204.55
66 210 90 204.62
67 230 90 204.69
68 250 90 204.76
69 270 90 204.831
70 10 110 204.901
71 30 110 204.971
72 50 110 205.041
73 70 110 205.111
74 90 110 205.181
75 110 110 205.251
76 130 110 205.321
77 150 110 205.391
78 170 110 205.461
79 190 110 205.531
80 210 110 205.601
81 230 110 205.671
82 250 110 205.741
83 270 110 205.811
84 10 130 205.881
85 30 130 205.951
86 50 130 206.021
87 70 130 206.091
88 90 130 206.161
89 110 130 206.231
90 130 130 206.301
91 150 130 206.371
92 170 130 206.441
93 190 130 206.511
94 210 130 206.581
95 230 130 206.651
96 250 130 206.721
97 270 130 206.791
98 10 150 206.861
99 30 150 206.931
100 50 150 207.001
101 70 150 207.071
102 90 150 207.141
103 110 150 207.211
104 130 150 207.281
105 150 150 207.351
106 170 150 207.421
107 190 150 207.491
108 210 150 207.561
109 230 150 207.631
110 250 150 207.701
111 270 150 207.771
112 10 170 207.841
113 30 170 207.911
114 50 170 207.981
115 70 170 208.051
116 90 170 208.121
117 110 170 208.191
118 130 170 208.261
119 150 170 208.331
120 170 170 208.401
121 190 170 208.471
122 210 170 208.541
123 230 170 208.611
124 250 170 208.681
125 270 170 208.751
126 10 190 208.821
127 30 190 208.891
128 50 190 208.961
129 70 190 209.031
130 90 190 209.101
131 110 190 209.171
132 130 190 209.241
133 150 190 209.311
134 170 190 209.381
135 190 190 209.451
136 210 190 209.521
137 230 190 209.591
138 250 190 209.661
139 270 190 209.731
140 10 210 209.801
141 30 210 209.871
142 50 210 209.941
143 70 210 210.011
144 90 210 210.081
145 110 210 210.151
146 130 210 210.221
147 150 210 210.291
148 170 210 210.361
149 190 210 210.431
150 210 210 210.501
151 230 210 210.571
152 250 210 210.641
153 270 210 210.711
154 10 230 210.781
155 30 230 210.851
156 50 230 210.921
157 70 230 210.991
158 90 230 211.061
159 110 230 211.131
160 130 230 211.201
161 150 230 211.271
162 170 230 211.341
163 190 230 211.411
164 210 230 211.481
165 230 230 211.551
166 250 230 211.621
167 270 230 211.691
168 10 250 211.761
169 30 250 211.831
170 50 250 211.901
171 70 250 211.971
172 90 250 212.041
173 110 250 212.111
174 130 250 212.181
175 150 250 212.251
176 170 250 212.321
177 190 250 212.391
178 210 250 212.461
179 230 250 212.531
180 250 250 212.601
181 270 250 212.671
182 10 270 212.741
183 30 270 212.811
184 50 270 212.881
185 70 270 212.951
186 90 270 213.021
187 110 270 213.091
188 130 270 213.161
189 150 270 213.231
190 170 270 213.301
191 190 270 213.371
192 210 270 213.441
193 230 270 213.511
194 250 270 213.581
195 270 270 213.651
